111111111111111
1E0C0000C0001C1
100000C0000P101
100001111110001
1CCCCCCCCCCCCC1
1CCCCCCCCCCCCC1
1CCCCCCCCCCCCC1
111111111111111
