11111111111111111111111
110C00000001111111111P1
1E000111000011111111001
11000000C00001111110011
10011000011111111110011
10C00000000000000000111
11111111111111111111111