11111111111111111111111
110C00000001111111111P1
1E00011000000C000011001
10011000011111111111011
11111110000000000001111
11111111111111111111111