1111111111111111111111111111111
1000C00000E00000000000000C00P01
1111111111111111111111111111111